######################
#....................#
#....................#
#....................#
#....................#
#v..................B#
#....................#
#....................#
#....................#
#....................#
#....................#
######################