######################
#....................#
#...............######
#...............#     
#...............######
#.........@.........^#
######...............#
     #...............#
######...............#
#....................#
#....................#
######################