######################
#....................#
#....................#
#....................#
#....................#
#^........O.........v#
#....................#
#....................#
#....................#
#....................#
#....................#
######################